6222222222222222222222222292922222222222222222222222224
1X☀☀☀☀☀☀☀☀☀☀☀☀☀☀☀☀☀☀☀☀☀☀☀X1☀1X☀☀☀☀☀☀☀☀☀☀☀☀☀☀☀☀☀☀☀☀☀☀☀X1
1X☀X6222224X☀X622222224X☀X1☀1X☀X622222224X☀X6222224X☀X1
1X☀X1X☀☀☀X1X☀X1X☀☀☀☀☀X1X☀X1☀1X☀X1X☀☀☀☀☀X1X☀X1X☀☀☀X1X☀X1
1X☀X3222225X☀X322222225X☀X325X☀X322222225X☀X3222225X☀X1
1X☀☀☀☀☀☀☀☀☀☀☀☀☀☀☀☀☀☀☀☀☀☀☀☀☀☀☀☀☀☀☀☀☀☀☀☀☀☀☀☀☀☀☀☀☀☀☀☀☀☀☀X1
1X☀X6222224X☀X624X☀X622222222222224X☀X624X☀X6222224X☀X1
1X☀X3222225X☀X1☀1X☀X3222224☀6222225X☀X1☀1X☀X3222225X☀X1
1X☀☀☀☀☀☀☀☀☀☀☀X1☀1X☀☀☀☀☀☀☀X1 1X☀☀☀☀☀☀☀X1☀1X☀☀☀☀☀☀☀☀☀☀☀X1
32222222224X☀X1 3222224X X1 1X X6222225 1X*X62222222225
         X1X*X1 6222225X X325X X3222224 1X*X1
         X1X*X1 1X                   X1 1X*X1X         
         X1X*X1 1X X622220000022224X X1 1X*X1X         
22222222225X*X325X X1X           X1X X325X*X32222222222
            *      X1X           X1X      *            
22222222224X*X624X X1X           X1X X624X*X62222222222
         X1X☀X1☀1X☀X322222222222225X☀X1☀1X☀X1X         
         X1X☀X1☀1X☀☀☀☀☀☀☀☀☀☀☀☀☀☀☀☀☀☀☀X1☀1X☀X1X         
         X1X☀X1☀1X☀X622222222222224X☀X1☀1X☀X1X         
62222222225X☀X325X☀X3222224☀6222225X☀X325X☀X32222222224
1X☀☀☀☀☀☀☀☀☀☀☀☀☀☀☀☀☀☀☀☀☀☀☀X1☀1X☀☀☀☀☀☀☀☀☀☀☀☀☀☀☀☀☀☀☀☀☀☀☀X1
1X☀X6222224X☀X622222224X☀X1☀1X☀X622222224X☀X6222224X☀X1
1X☀X32224☀1X☀X322222225X☀X325X☀X322222225X☀X1☀62225X☀X1
1X☀☀☀☀☀X1☀1X☀☀☀☀☀☀☀☀☀☀☀☀☀☀☀☀☀☀☀☀☀☀☀☀☀☀☀☀☀☀☀X1☀1X☀☀☀☀☀X1
82224X☀X1☀1X☀X624X☀X622222222222224X☀X624X☀X1☀1X☀X62227
82225X☀X325X☀X1☀1X☀X3222224☀6222225X☀X1☀1X☀X325X☀X32227
1X☀☀☀☀☀☀☀☀☀☀☀X1☀1X☀☀☀☀☀☀☀X1☀1X☀☀☀☀☀☀☀X1☀1X☀☀☀☀☀☀☀☀☀☀☀X1
1X☀X62222222225☀3222224X☀X1☀1X☀X6222225☀32222222224X☀X1
1X☀X3222222222222222225X☀X325X☀X3222222222222222225X☀X1
1X☀☀☀☀☀☀☀☀☀☀☀☀☀☀☀☀☀☀☀☀☀☀☀☀☀☀☀☀☀☀☀☀☀☀☀☀☀☀☀☀☀☀☀☀☀☀☀☀☀☀☀X1
3222222222222222222222222222222222222222222222222222225
