                                                       
  ***********************  *  ***********************  
  *         *           *  *  *           *         *  
  *   ***   *   *****   *  *  *   *****   *   ***   *  
  *         *           *     *           *         *  
  ***************************************************  
  *         *     *                 *     *         *  
  *         *  *  *        *        *  *  *         *  
  ***********  *  *******     *******  *  ***********  
            *                             *            
            *                             *  
            *                             *            
            *                             *            
            *                             *            
            *                             *            
            *                             *            
            *  *  *                 *  *  *            
            *  *  *******************  *  *            
            *  *  *                 *  *  *            
            *     *        *        *     *            
  ***********************  *  ***********************  
  *         *           *  *  *           *         *  
  *      *  *           *     *           *  *      *  
  *****  *  *******************************  *  *****  
      *  *  *     *                 *     *  *  *      
      *     *  *  *        *        *  *  *     *      
  ***********  *  *******  *  *******  *  ***********  
  *            *        *  *  *        *            *  
  *                     *     *                     *  
  ***************************************************  
                                                       
