6222222222222222222222222292922222222222222222222222224
1XY Y Y Y Y Y Y Y Y Y Y YX1 1XY Y Y Y Y Y Y Y Y Y Y YX1
1XYX6222224XYX622222224XYX1 1XYX622222224XYX6222224XYX1
1XZX1X   X1XYX1X     X1XYX1 1XYX1X     X1XYX1X   X1XZX1
1XYX3222225XYX322222225XYX325XYX322222225XYX3222225XYX1
1XY Y Y Y Y Y Y Y Y Y Y Y Y Y Y Y Y Y Y Y Y Y Y Y Y YX1
1XYX6222224XYX624XYX622222222222224XYX624XYX6222224XYX1
1XYX3222225XYX1 1XYX3222224 6222225XYX1 1XYX3222225XYX1
1XY Y Y Y Y YX1 1XY Y Y YX1 1XY Y Y YX1 1XY Y Y Y Y YX1
32222222224XYX1 3222224X X1 1X X6222225 1XYX62222222225
         X1XYX1 6222225X X325X X3222224 1XYX1
         X1XYX1 1X                   X1 1XYX1X         
         X1XYX1 1X X622220000022224X X1 1XYX1X         
22222222225XYX325X X1X           X1X X325XYX32222222222
            Y      X1X           X1X      Y            
22222222224XYX624X X1X           X1X X624XYX62222222222
         X1XYX1 1X X322222222222225X X1 1XYX1X         
         X1XYX1 1X                   X1 1XYX1X         
         X1XYX1 1X X622222222222224X X1 1XYX1X         
62222222225XYX325X X3222224 6222225X X325XYX32222222224
1XY Y Y Y Y Y Y Y Y Y Y YX1 1XY Y Y Y Y Y Y Y Y Y Y YX1
1XYX6222224XYX622222224XYX1 1XYX622222224XYX6222224XYX1
1XYX32224 1XYX322222225XYX325XYX322222225XYX1 62225XYX1
1XZ Y YX1 1XY Y Y Y Y Y Y     Y Y Y Y Y Y YX1 1XY Y ZX1
82224XYX1 1XYX624XYX622222222222224XYX624XYX1 1XYX62227
82225XYX325XYX1 1XYX3222224 6222225XYX1 1XYX325XYX32227
1XY Y Y Y Y YX1 1XY Y Y YX1 1XY Y Y YX1 1XY Y Y Y Y YX1
1XYX62222222225 3222224XYX1 1XYX6222225 32222222224XYX1
1XYX3222222222222222225XYX325XYX3222222222222222225XYX1
1XY Y Y Y Y Y Y Y Y Y Y Y Y Y Y Y Y Y Y Y Y Y Y Y Y YX1
3222222222222222222222222222222222222222222222222222225
